11111111100000000000000000000000000000000000000000000000000000000000000000000000
11111111100000000000000000000000000000000000000000000000000000000000000000000000
11111111111000000000000000000000000000000000000000000000000000000000000000000000
11111111111000000000000000000000000000000000000000000000000000000000000000000000
11111111111100000000000000000000000000000000000000000000000000000000000000000000
01111100011100000000000000000000000000000000000000000000000000000000000000000000
00110000001110000000000000000000000000000000000000000000000000000000000000000000
00000000001110000000000000000000000000000000000000000000000000000000000000000000
00000000000110000000000000000000000000000000000000000000000000000000000000000000
00000000000110000000000000000000000000000000000000000000000000000000000000000000
00000000000110000000000000000000000000000000000000000000000000000000000000000000
00000000000110000000000000000000000000000000000000000000000000000000000000000000
00000000000110000000000000000000000000000000000000000000000000000000000000000000
00000000001110000000000000000000000000000000000000000000000000000000000000000000
00000000001110000000000000000000000000000000000000000000000000000000000000000000
00000000001100000000000000000000000000000000000000000000000000000000000000000000
00000000011100000000000000000000000000000000000000000000000000000000000000000000
00000000011100000000000000000000000000000000000000000000000000000000000000000000
00000000011000000000000000000000000000000000000001111111000000000000000000000000
00000000011000000000000000000000000000000000000011111111110000000000000000000000
00000000111000000000000000000000000000000000000011100001111110000000000000000000
00000000111000000000000000000000000000000000000011000000111111000000000000000000
00000000110000000000000000000000000000000000000011000000000111110000000000000000
00000001110000000000000000000000000000000000000011000000000011111000000000000000
00000001110000000000000000000000000000000000000011000000000000111100000000000000
00000001100000000000000000000000000000000000000011000000000000011100000000000000
00000001100000000000000000000000000000000000000011000000000000001110000000000000
00000001100000000000000000000000000000000000000011000000000000001111000000000000
00000001100000000000000000000000000000000000000011100000000000000111000000000000
00000001100000000000000000000000000000000000000011110000000000000011100000000000
00000001100000000000000000000000000000000000000001110000000000000001100000000000
00000001100000000000000000000000000000000000000000111000000000000001100000000000
00000001100000000000000000000000000000000000000000111000000000000001100000000000
00000001100000000000000000000000000000000000000000011111000000000001100000000000
00000001100000000000000000000000000000000000000000011111100000000001100000000000
00000001110000000000000000000000000000000000000000000011111000000001100000000000
00000001110000000000000000000000000000000000000000000001111110000001100000000000
00000000110000000000000000000000000000000000000000000000011110000001100000000000
00000000110000000000000000000000000000000000000000000000000111100011100000000000
00000000111000000000000000000000000000000000000000000000000111110011100000000000
00000000111000000000000000000000000000000000000000000000000001111011000000000000
00000000011100000000000000000000000000000000000000000000000000111011000000000000
00000000011110000000000000000000000000000000000000000000000000011111000000000000
00000000001111100000000000000000000000000000000000000000000000011111000000000000
00000000000111111000000000000000000000000000000000000000000000001111000000000000
00000000000001111100000000000000000000000000000000000000000000001111000000000000
00000000000000011110000000000000000000000000000000000000000000001110000000000000
00000000000000001111100000000000000000000000000000000000000000011110000000000000
00000000000000000111111000000111111111111111111111000000000000011110000000000000
00000000000000000001111111111111111111111111111111110000000000111110000000000000
00000000000000000000011111111110000000000000000011111110000000111110000000000000
00000000000000000111111111110000000000000000000000111111100011110110000000000000
00000000000000001111111001111000000000000000000000000111111111110110000000000000
00000000000000011110000000111000000000000000000000000001111111000110000000000000
00000000000000111100000000011100000000000000000000000000000011001110000000000000
00000000000000111000000000011110000000000000000000000000000000001110000000000000
00000000000001110000000000001110000000000000000000000000000000001100000000000000
00000000000001110000000000000110000000000000000000000000000000001100000000000000
00000000000001100000000000000111000000000000000000000000000000001100000000000000
00000000000001100000000000000111000000000000000000000000000000001110000000000000
00000000000001100000000000000011000000000000000000000000000000001110000000000000
00000000000001110000000000001111000000000000000000000000000000000111000000000000
00000000000001111000000000011111000000000000000000000000000000000111110000000000
00000000000000111110000001111100000000000000000000000000000000000011111100000000
00000000000000011111111111111000000000000000000000000000000000000000111111000000
00000000000000000111111111100000000000000000000000000000000000000000001111100000
00000000000000000000000000000000000000000000000000000000000000000000000011111000
00000000000000000000000000000000000000000000000000000000000000000000000001111000
00000000000000000000000000000000000000000000000000000000000000000000000000011111
00000000000000000000000000000000000000000000000000000000000000000000000000011111
00000000000000000000000000000000000000000000000000000000000000000000000001111111
00000000000000000000000000000000000000000000000000000000000000000000000011111111
00000000000000000000000000000000000000000000000000000000000000000000000111111111
00000000000000000000000000000000000000000000000000000000000000000000011111111111
00000000000000000000000000000000000000000000000000000000000000000000111111111111
00000000000000000000000000000000000000000000000000000000000000000000111111111111
00000000000000000000000000000000000000000000000000000000000000000000111111111111
00000000000000000000000000000000000000000000000000000000000000000000000111111111
00000000000000000000000000000000000000000000000000000000000000000000000111111111
00000000000000000000000000000000000000000000000000000000000000000000001111111111
