10000000000000000000000000000000000000000000000000000000000000000000000000000000
11111111111111100000000000000000000000000000000000000000000000000000000000000000
11111111111111100000000000000000000000000000000000000000000000000000000000000000
00111000000111100000000000000000000000000000000000000000000000000000000000000000
00000000000011100000000000000000000000000000000000000000000000000000000000000000
00000000000011000000000000000000000000000000000000000000000000000000000000000000
00000000000011000000000000000000000000000000000000000000000000000000000000000000
00000000000011000000000000000000000000000000000000000000000000000000000000000000
00000000000011000000000000000000000000000000000000000000000000000000000000000000
00000000000011000000000000000000000000000000000000000000000000000000000000000000
00000000000011000000000000000000000000000000000000000000000000000000000000000000
00000000000011000000000000000000000000000000000000000000000000000000000000000000
00000000000011000000000000000000000000000000000000000000000000000000000000000000
00000000000011000000000000000000000000000000000000000000000000000000000000000000
00000000000011000000000000000000000000000000000000000000000000000000000000000000
00000000000011000000000000000000000000000000000000000000000000000000000000000000
00000000000011000000000000000000000000000000000000000000001111111111110000000000
00000000000011000000000000000000000000000000000111110000111111111111110000000000
00000000000011000000000000000000000000001111111111110000111100000000111000000000
00000000000011000000000000000000000111111111111110110000110000000000111000000000
00000000000011000000000000011111111111111100000000110000110000000000011000000000
00000000000011000000000000011111111110000000000000110000110000000000011000000000
00000000000011000000000000011000000000000000000000110000110000000000011100000000
00000000000011000000000000011000000000000000000000110000110000000000011100000000
00000000000011000000000000011000000000000000000000110000110000000000001100000000
00000000000011000000000000011000000000000000000000110000110000000000001100000000
00000000000011000000000000011100000000000000000000110000110000000000001100000000
00000000000011000000000000011100000000000000000000111000110000000000001100000000
00000000000011000000000000001100000000000000000000111001110000000000001100000000
00000000000011000000000000001100000000000000000000011001110000000000001100000000
00000000000011000000000000001100000000000000000000011001100000000000001100000000
00000000000011000000000000001100000000000000000000011001100000000000001100000000
00000000000011000000000000001100000000000000000000011001100000000000001100000000
00000000000011000000000000001110000000000000000000011001100000000000001100000000
00000000000011000000000000001110000000000000000000011011100000000000001100000000
00000000000011000000000000000111000000000000000000011011100000000000001100000000
00000000000011000000000000000111000000000000000000011011000000000000001100000000
00000000000011000000000000000011000000000000000000011011000000000000001100000000
00000000000011000000000000000011000000000000000000011011000000000000001100000000
00000000000011001111111111111111000000000000000000011011000000000000001100000000
00000000000011111111111111111111000000000000000000011011000000000000001100000000
00000000000011111100000000000000000000000000000000011011000000000000001110000000
00000000000000000000000000000000000000000000000000011011100000000000001110000000
00000000000000000000000000000000000000000000000000011011100000000000000110000000
00000000000000000000000000000000000000000000000000011001100000000000000110000000
00000000000000000000000000000000000000000000000000011001100000000000000110000000
00000000000000000000000000000000000000000000000000011101100000000000000111000000
00000000000000000000000000000000000000000000000011111101100000000000000111000000
00000000000000000000000000000000000000000111111111111101100000000000000011000000
00000000000000000000000001111111111111111111111111000001100000000000000011000000
00000000000000000000000011111111111111111110000000000001110000000000000011000000
00000000000000000000000011100000000000000000000000000001110000000000000011000000
00000000000000000000000011000000000000000000000000000000110000000000000011000000
00000000000000000000000011000000000000000000000000000000110000000000000011000000
00000000000000000000000011000000000000000000000000000000110000000000000011000000
00000000000000000000000011000000000000000000000000000000110000000000000111000000
00000000000000000000000011000000000000000000000000000000110000000000001111000000
00000000000000000000000011000000000000000000000000000000110000000000001100000000
00000000000000000000000111000000000000000000000000000000110000000000001100000000
00000000000000000000000111000000000000000000000000000000110000000000011100000000
00000000000000000000000110000000000000000000000000000000110000000000011100000000
00000000000000000000000110000000000000000000000000000001110000000000011000000000
00000000000000000000000110000000000000000000000001111111110000000000011000000000
00000000000000000000000110001111111111111111111111111111100000000000011000000000
00000000000000000000000111111111111111111111111111000000000000000000111000000000
00000000000000000000000111111100000000000000000000000000000000000000111000000000
00000000000000000000000000000000000000000000000000000000000000000000110000000000
00000000000000000000000000000000000000000000000000000000000000000000110000000000
00000000000000000000000000000000000000000000000000000000000000000000110000000000
00000000000000000000000000000000000000000000000000000000000000000000110000000000
00000000000000000000000000000000000000000000000000000000000000000000110000000000
00000000000000000000000000000000000000000000000000000000000000000000110000000000
00000000000000000000000000000000000000000000000000000000000000000000110000000000
00000000000000000000000000000000000000000000000000000000000000000000110000000000
00000000000000000000000000000000000000000000000000000000000000000000110000000000
00000000000000000000000000000000000000000000000000000000000000000000110000000000
00000000000000000000000000000000000000000000000000000000000000000000110000000000
00000000000000000000000000000000000000000000000000000000000000000000110000000000
00000000000000000000000000000000000000000000000000000000000000000000110000000000
00000000000000000000000000000000000000000000000000000000000000000000111111111111
